####################################################################
#..................................................................#
#..................................................................#
#..................................................................#
#..................................................................#
#..................................................................#
#..................................................................#
#..................................................................#
#..................................................................#
#..................................................................#
#..................................................................#
#..................................................................#
#..................................................................#
#..............................X...................................#
#..................................................................#
####################################################################